0       1               1       1               2       1               3       1
4       1               5       1               6       1               7       1
8       1               9       1               10      1               11      1
12      1               13      1               14      1               15      1
16      1               17      1               18      1               19      1
20      1               21      1               22      1               23      1
24      1               25      1               26      1               27      1
28      1               29      1               30      1               31      1
32      1               33      1               34      1               35      1
36      1               37      1               38      1               39      1
40      1               41      1               42      1               43      1
44      1               45      1               46      1               47      1
48      1               49      1               50      1               51      1
52      1               53      1               54      1               55      1
56      1               57      1               58      1               59      1
60      1               61      1               62      1               63      1
64      1               65      0               66      0               67      1
68      1               69      1               70      1               71      1
72      1               73      1               74      1               75      1
76      0               77      0               78      1               79      1
80      1               81      1               82      1               83      1
84      1               85      1               86      1               87      1
88      1               89      1               90      1               91      1
92      1               93      1               94      1               95      1
96      1               97      1               98      1               99      1
100     0               101     0               102     0               103     0
104     0               105     0               106     0               107     0
108     0               109     0               110     0               111     0
112     0               113     0               114     0               115     0
116     0               117     0               118     0               119     0
120     0               121     0               122     0               123     0
124     0               125     0               126     0               127     0