VIRT: 0         PHY: 63         AUX: 0100
VIRT: 1         PHY: 64         AUX: 0100
VIRT: 2         PHY: -1         AUX: 0000
VIRT: 3         PHY: -1         AUX: 0000
VIRT: 4         PHY: 69         AUX: 0100
VIRT: 5         PHY: 70         AUX: 0100
VIRT: 6         PHY: -1         AUX: 0000
VIRT: 7         PHY: -1         AUX: 0000
VIRT: 8         PHY: 81         AUX: 0110
VIRT: 9         PHY: -1         AUX: 0000